###############################
#      ** *  1 * 2 *  * * *   #
# # # #*# # #*#*# # # #*#*#*# #
#   * *   ***  *  1   * 2 * * #
# # # # # #*# # #*#*# # # # #*#
#   p *    x **  *  *   1     #
# # ###   # # # # #** #*# # # #
#*  *     **  *      *        #
# ### # #*# # # #*#*# * # # # #
#*    **  * *   2 *           #
# #*# * # # # # #*# # # # # # #
#  1        *1  *  *          #
###############################