###############################
#      ** *  1 *   *  * * *   #
# # # #*# # #*#*# # # #*#*#*# #
#p  *     ***  *  1   *   * * #
# # # # # #*# # #*#*# # # # #*#
#            **  *  *         #
# # # # # # # # # #*# #*# # # #
#*  *      *  *      *        #
# # # # #*# # # #*#*# # # # # #
#*  1  **  *       *          #
# #*# # # # # # #*# # # # # # #
#         x *   *  *    1     #
###############################