###############################
#      ** *  1 * 2 *  * * *   #
# # # #*# # #*#*# # # #*#*#*# #
#   *     ***  *  1   * 2 * * #
# # # # # #*# # #*#*# # # # #*#
#          x **  *  *   1     #
# # # # # # # # # #*# #*# # # #
#*  *      *p *      *        #
# # # # #*# # # #*#*# # # # # #
#*    **  *     2 *           #
# #*# # # # # # #*# # # # # # #
#  1        *1  *  *          #
###############################